,Id,Lot Frontage,Lot Area,Mas Vnr Area,BsmtFin SF 1,BsmtFin SF 2,Bsmt Unf SF,Total Bsmt SF,1st Flr SF,2nd Flr SF,Low Qual Fin SF,Gr Liv Area,Garage Area,Wood Deck SF,Open Porch SF,Enclosed Porch,3Ssn Porch,Screen Porch,Pool Area
0,2658,69.0,9142,0.0,0,0,1020,1020,908,1020,0,1928,440,0,60,112,0,0,0
1,2718,0.0,9662,0.0,0,0,1967,1967,1967,0,0,1967,580,170,0,0,0,0,0
2,2414,58.0,17104,0.0,554,0,100,654,664,832,0,1496,426,100,24,0,0,0,0
3,1989,60.0,8520,0.0,0,0,968,968,968,0,0,968,480,0,0,184,0,0,0
4,625,0.0,9500,247.0,609,0,785,1394,1394,0,0,1394,514,0,76,0,0,185,0
5,333,21.0,1890,0.0,294,0,252,546,546,546,0,1092,286,0,0,64,0,0,0
6,1327,52.0,8516,0.0,0,0,869,869,1093,0,0,1093,308,0,0,0,0,0,0
7,858,0.0,9286,0.0,196,0,1072,1268,1268,0,0,1268,252,173,0,0,0,0,0
8,95,39.0,3515,0.0,0,0,840,840,840,840,0,1680,588,0,111,0,0,0,0
9,1568,75.0,10125,0.0,641,279,276,1196,1279,0,0,1279,473,238,83,0,0,0,0
10,2482,50.0,7175,0.0,278,0,939,1217,1217,0,0,1217,484,0,64,0,0,0,0
11,1364,60.0,7200,0.0,0,0,1040,1040,1040,0,0,1040,320,0,132,0,0,0,0
12,2584,75.0,11310,0.0,0,0,1367,1367,1375,0,0,1375,451,0,30,0,0,0,0
13,818,0.0,7976,23.0,820,0,348,1168,1168,1619,0,2787,820,312,0,0,0,0,0
14,2673,69.0,11737,0.0,0,0,848,848,1017,810,0,1827,240,27,36,42,0,0,0
15,2089,60.0,9060,98.0,0,0,0,0,1340,0,0,1340,252,116,0,0,180,0,0
16,1297,60.0,10800,0.0,590,0,294,884,884,552,0,1436,828,0,0,126,0,0,0
17,790,68.0,9571,0.0,257,0,816,1073,1073,0,0,1073,340,0,0,0,0,0,0
18,2616,80.0,10800,104.0,913,0,400,1313,1773,0,0,1773,418,355,98,0,0,144,0
19,720,121.0,17671,0.0,216,0,700,916,916,826,0,1742,424,0,169,0,0,0,0
20,222,0.0,8246,0.0,188,668,204,1060,1060,0,0,1060,270,406,90,0,0,0,0
21,557,0.0,8499,0.0,660,0,204,864,864,0,0,864,732,0,312,0,0,0,0
22,1148,50.0,8012,0.0,165,841,598,1604,1617,0,0,1617,533,0,69,0,0,0,0
23,2766,0.0,21453,0.0,938,0,0,938,988,0,0,988,540,0,130,0,130,0,0
24,534,80.0,9605,0.0,0,0,1218,1218,1218,0,0,1218,576,0,178,0,0,0,0
25,1452,60.0,7180,0.0,390,0,474,864,864,0,0,864,352,0,0,0,0,0,0
26,630,0.0,12513,0.0,0,0,715,715,1281,457,0,1738,368,55,0,0,0,0,0
27,2648,50.0,9000,0.0,0,0,636,636,1089,661,0,1750,240,0,0,293,0,0,0
28,125,80.0,8800,156.0,763,0,173,936,1054,0,0,1054,480,120,0,0,0,0,0
29,1904,51.0,3500,0.0,144,0,226,370,442,228,0,670,0,0,21,0,0,0,0
30,1670,0.0,7340,0.0,322,0,536,858,858,0,0,858,684,0,0,0,0,0,0
31,756,52.0,6240,0.0,152,0,628,780,848,0,360,1208,539,0,23,112,0,0,0
32,717,65.0,11700,0.0,0,0,1240,1240,1320,1320,0,2640,864,181,0,386,0,0,0
33,1032,80.0,10000,0.0,1084,0,92,1176,1178,0,0,1178,439,224,0,0,0,0,0
34,852,75.0,11166,180.0,24,0,1468,1492,1492,0,0,1492,608,0,114,0,0,168,0
35,1731,58.0,13204,44.0,0,0,608,608,608,850,0,1458,454,100,33,0,0,0,0
36,2639,60.0,5520,0.0,284,0,863,1147,1147,510,0,1657,162,0,0,0,0,0,0
37,2071,0.0,9000,0.0,0,0,0,0,998,0,0,998,460,0,0,140,0,0,0
38,1267,74.0,8892,0.0,0,0,105,105,910,0,0,910,414,196,0,150,0,0,0
39,1851,73.0,7321,0.0,0,0,1339,1339,1358,0,0,1358,625,176,174,0,0,0,0
40,567,40.0,3951,76.0,0,0,612,612,612,612,0,1224,528,0,234,0,0,0,0
41,2439,0.0,11214,0.0,0,0,930,930,956,930,0,1886,431,89,0,0,0,0,0
42,1898,75.0,7388,0.0,405,0,658,1063,1327,0,0,1327,624,0,0,0,0,0,0
43,647,75.0,14559,70.0,650,180,178,1008,1363,0,0,1363,288,324,42,0,0,168,0
44,2256,46.0,4054,352.0,949,0,552,1501,1501,0,0,1501,512,240,0,0,0,0,0
45,979,21.0,1533,0.0,0,0,546,546,798,546,0,1344,0,0,0,0,0,0,0
46,1444,68.0,11250,162.0,486,0,434,920,920,866,0,1786,608,0,42,0,0,0,0
47,2485,60.0,7800,0.0,641,0,187,828,965,0,0,965,300,421,0,0,0,0,0
48,157,74.0,5868,0.0,248,240,448,936,936,0,0,936,308,0,0,80,0,160,0
49,88,75.0,7500,0.0,824,0,216,1040,1040,0,0,1040,308,0,0,220,0,0,0
50,2003,52.0,9439,0.0,324,0,588,912,912,336,0,1248,160,0,0,192,0,0,0
51,186,50.0,9000,0.0,0,0,346,346,1157,1111,0,2268,624,0,108,0,0,0,0
52,1425,65.0,9345,156.0,0,0,1615,1615,1615,0,0,1615,864,168,30,0,0,0,0
53,2695,60.0,7200,0.0,0,0,803,803,803,557,0,1360,297,0,65,190,0,0,0
54,738,60.0,6000,444.0,220,0,248,468,822,320,0,1142,320,0,0,98,0,0,0
55,395,61.0,7930,0.0,439,472,115,1026,1026,0,0,1026,440,171,48,0,0,0,0
56,1353,60.0,9120,0.0,329,0,697,1026,1133,687,0,1820,240,0,100,0,0,0,0
57,1878,0.0,9503,0.0,457,374,193,1024,1344,0,0,1344,484,316,28,0,0,0,0
58,390,85.0,11050,0.0,636,0,540,1176,1193,0,0,1193,506,40,0,0,0,0,0
59,1456,0.0,10316,0.0,735,0,257,992,992,873,0,1865,839,0,184,0,0,0,0
60,1103,136.0,11675,495.0,1660,0,322,1982,2006,0,0,2006,938,144,33,0,0,0,0
61,1387,60.0,12900,0.0,1300,0,0,1300,1140,0,0,1140,400,0,0,190,0,0,0
62,2070,85.0,13770,340.0,190,873,95,1158,1176,0,0,1176,303,0,0,0,0,0,0
63,1199,0.0,13355,0.0,583,0,242,825,845,825,0,1670,464,0,0,0,0,0,0
64,2479,65.0,7153,0.0,387,0,374,761,810,793,0,1603,484,0,124,0,0,0,0
65,501,0.0,10750,634.0,236,1526,262,2024,2063,0,0,2063,815,182,56,0,0,0,0
66,2362,0.0,8125,0.0,614,0,244,858,858,0,0,858,0,0,0,0,0,0,0
67,1718,34.0,3903,182.0,1030,0,272,1302,1302,0,0,1302,631,110,50,0,0,0,0
68,2188,70.0,4270,0.0,544,0,0,544,774,0,0,774,0,0,0,286,0,0,0
69,1483,0.0,4426,147.0,697,0,151,848,848,0,0,848,420,149,0,0,0,0,0
70,2557,52.0,5825,108.0,0,0,600,600,747,0,0,747,528,0,0,32,0,0,0
71,437,59.0,23303,20.0,1230,0,278,1508,1508,1012,0,2520,640,192,273,0,0,0,0
72,2224,0.0,25485,423.0,540,1020,0,1560,1560,0,0,1560,580,0,75,584,0,0,0
73,1628,0.0,10784,76.0,0,0,384,384,802,670,0,1472,402,164,0,0,0,0,0
74,397,0.0,8510,178.0,500,0,543,1043,1050,0,0,1050,336,0,0,0,0,0,0
75,587,0.0,17871,359.0,528,0,1152,1680,1724,0,0,1724,480,0,0,0,0,0,0
76,971,100.0,21750,75.0,0,0,0,0,1771,0,0,1771,336,0,0,0,0,0,0
77,2611,77.0,9510,161.0,701,0,434,1135,1207,0,0,1207,264,0,240,0,0,0,0
78,1887,0.0,8339,0.0,0,0,0,0,882,0,0,882,294,0,0,0,0,0,0
79,2399,131.0,14828,674.0,1383,0,397,1780,1780,0,0,1780,816,144,68,0,0,0,0
80,2148,70.0,8749,100.0,0,0,1459,1459,1459,0,0,1459,527,192,39,0,0,0,0
81,304,50.0,9140,0.0,308,0,321,629,727,380,0,1107,625,0,56,0,0,200,0
82,1997,60.0,3600,0.0,316,0,371,687,687,671,0,1358,336,0,32,0,0,0,0
83,2817,67.0,8777,0.0,173,337,166,676,760,676,0,1436,528,147,0,0,0,0,0
84,1431,79.0,12798,0.0,462,0,154,616,616,1072,0,1688,603,403,114,185,0,0,0
85,427,98.0,12704,306.0,0,0,2042,2042,2042,0,0,2042,1390,0,90,0,0,0,0
86,263,68.0,7480,0.0,480,0,396,876,876,0,0,876,484,0,0,0,0,0,0
87,598,0.0,16500,509.0,962,0,270,1232,1320,0,0,1320,495,0,20,0,0,0,0
88,2895,0.0,16669,653.0,0,0,1686,1686,1707,0,0,1707,511,574,64,0,0,0,0
89,687,60.0,8064,0.0,120,0,744,864,1064,0,431,1495,576,180,36,0,0,0,0
90,1822,0.0,7758,0.0,588,0,411,999,999,0,0,999,264,0,132,0,0,0,0
91,2191,70.0,11767,0.0,0,0,560,560,796,550,0,1346,384,168,24,0,0,0,0
92,179,50.0,6900,0.0,0,0,827,827,827,424,0,1251,240,0,0,0,0,0,0
93,1009,40.0,4671,0.0,767,0,461,1228,1228,0,0,1228,472,168,120,0,0,0,0
94,2010,50.0,6125,0.0,306,0,422,728,728,546,0,1274,224,0,0,192,0,0,0
95,1991,53.0,9863,0.0,196,210,322,728,914,728,0,1642,374,0,0,0,0,0,0
96,1411,68.0,9571,0.0,870,0,639,1509,1509,0,0,1509,322,158,0,0,0,576,0
97,1721,34.0,4590,108.0,24,0,1530,1554,1554,0,0,1554,627,156,73,0,0,0,0
98,1144,65.0,8450,0.0,472,0,355,827,827,850,0,1677,627,0,68,0,0,0,0
99,593,70.0,8400,0.0,643,0,167,810,810,855,0,1665,528,0,45,0,0,0,0
100,575,0.0,14694,450.0,1252,136,306,1694,1694,0,0,1694,642,501,120,0,225,0,0
101,1249,95.0,14250,360.0,0,0,998,998,1790,0,0,1790,540,0,40,0,0,0,0
102,1604,37.0,6951,0.0,658,0,218,876,923,0,0,923,264,362,0,0,0,0,0
103,1064,106.0,12720,680.0,2257,0,278,2535,2470,0,0,2470,789,154,65,0,0,216,144
104,1923,90.0,11988,0.0,777,0,467,1244,1244,0,0,1244,336,0,40,0,0,0,0
105,1988,40.0,3880,0.0,329,0,357,686,866,0,0,866,0,58,42,0,0,0,0
106,2325,0.0,7685,112.0,518,0,179,697,697,804,0,1501,420,190,63,0,0,0,0
107,114,0.0,18837,0.0,687,46,491,1224,1287,604,0,1891,678,0,69,0,0,0,0
108,2700,120.0,11136,0.0,0,0,1921,1921,1921,0,0,1921,576,0,180,0,0,0,0
109,217,72.0,10773,72.0,704,0,1128,1832,1832,0,0,1832,0,0,58,0,0,0,0
110,343,85.0,10200,440.0,844,0,590,1434,1434,0,0,1434,528,80,21,0,0,0,0
111,386,0.0,7500,0.0,0,0,1058,1058,1058,816,0,1874,588,0,134,0,0,0,0
112,2005,76.0,11800,0.0,0,0,0,0,1382,0,0,1382,384,0,40,0,0,0,0
113,2908,90.0,17217,0.0,0,0,1140,1140,1140,0,0,1140,0,36,56,0,0,0,0
114,1814,0.0,16196,0.0,1443,0,39,1482,1494,0,0,1494,514,402,25,0,0,0,0
115,2446,118.0,35760,1378.0,1387,0,543,1930,1831,1796,0,3627,807,361,76,0,0,0,0
116,208,76.0,7630,0.0,0,0,360,360,1032,780,0,1812,672,344,0,40,0,0,0
117,1679,24.0,2016,304.0,0,0,630,630,630,672,0,1302,440,0,0,0,0,0,0
118,822,65.0,10816,364.0,1104,0,616,1720,1720,0,0,1720,846,208,104,0,0,0,0
119,6,78.0,9978,20.0,602,0,324,926,926,678,0,1604,470,360,36,0,0,0,0
120,1781,98.0,12291,754.0,1572,0,394,1966,1966,0,0,1966,1092,76,52,0,0,0,0
121,2397,86.0,11065,788.0,0,0,1085,1085,1120,850,0,1970,753,177,74,0,0,0,0
122,2340,60.0,8147,230.0,1191,0,523,1714,1714,0,0,1714,517,156,55,0,0,0,0
123,1618,0.0,13869,0.0,182,0,612,794,794,676,0,1470,388,0,75,0,0,0,0
124,2843,60.0,6204,0.0,0,0,795,795,954,795,481,2230,440,0,188,0,0,0,0
125,1061,102.0,12151,368.0,1249,0,165,1414,1414,917,0,2331,1003,192,63,0,0,0,0
126,2786,120.0,9560,0.0,360,0,504,864,864,0,0,864,288,0,0,0,0,0,0
127,1935,66.0,8923,0.0,643,0,365,1008,1008,0,0,1008,240,0,18,0,0,0,0
128,1341,60.0,5520,0.0,68,0,497,565,565,651,0,1216,355,0,0,180,0,0,0
129,521,112.0,12606,120.0,0,0,1530,1530,1530,0,0,1530,984,212,136,0,0,0,0
130,2136,59.0,8660,113.0,502,0,513,1015,1025,0,0,1025,370,127,0,0,0,0,0
131,996,59.0,9042,0.0,828,0,115,943,943,695,0,1638,472,100,38,0,0,0,0
132,227,86.0,11227,0.0,267,453,0,720,720,720,0,1440,480,192,38,0,0,0,0
133,135,75.0,11380,216.0,944,0,136,1080,1128,0,0,1128,315,238,0,0,0,0,0
134,1167,24.0,2280,216.0,550,0,194,744,757,792,0,1549,440,0,32,0,0,0,0
135,294,78.0,10452,371.0,426,252,850,1528,1225,908,0,2133,312,0,0,86,0,0,0
136,1776,75.0,9910,0.0,0,0,1369,1369,1369,0,0,1369,605,0,203,0,0,0,0
137,540,63.0,13072,0.0,0,0,1114,1114,1114,0,0,1114,576,248,102,0,0,0,0
138,1717,34.0,3901,182.0,866,0,436,1302,1302,0,0,1302,631,110,50,0,0,0,0
139,2303,65.0,11625,0.0,596,0,220,816,816,0,0,816,264,330,0,0,0,0,0
140,116,78.0,9360,0.0,982,0,179,1161,1381,0,0,1381,676,0,0,0,0,0,0
141,127,68.0,9717,0.0,49,1029,0,1078,1078,0,0,1078,240,366,0,112,0,0,0
142,1371,60.0,10320,0.0,0,0,756,756,756,713,0,1469,216,57,0,239,0,0,0
143,1014,0.0,31220,0.0,0,0,1632,1632,1474,0,0,1474,495,0,0,144,0,0,0
144,1507,57.0,8050,0.0,0,0,0,0,929,208,0,1137,0,0,0,0,0,0,0
145,702,60.0,7596,360.0,0,0,960,960,960,1000,0,1960,400,0,0,0,0,0,0
146,750,57.0,8094,0.0,0,0,1048,1048,1048,720,0,1768,576,0,0,150,0,0,0
147,261,0.0,10900,153.0,378,0,311,689,689,703,0,1392,299,0,36,0,0,0,0
148,1559,60.0,9000,0.0,0,0,592,592,432,432,0,864,216,0,30,160,0,0,0
149,577,110.0,15417,0.0,121,0,1619,1740,1740,0,0,1740,540,228,20,218,0,0,0
150,2812,89.0,11645,0.0,0,0,860,860,860,860,0,1720,565,0,70,0,0,0,0
151,2080,70.0,10512,0.0,491,0,497,988,988,638,0,1626,332,366,0,0,0,0,0
152,1368,60.0,5586,0.0,0,0,901,901,1088,110,0,1198,0,0,98,0,0,0,0
153,2376,68.0,7838,0.0,769,0,95,864,900,0,0,900,288,175,144,0,0,0,0
154,659,52.0,9022,0.0,0,0,768,768,792,0,0,792,240,316,0,120,0,0,0
155,1235,0.0,7390,151.0,902,0,196,1098,1098,0,0,1098,260,0,0,0,0,0,0
156,332,21.0,1900,0.0,0,0,546,546,546,546,0,1092,0,0,0,0,0,0,0
157,1917,73.0,8760,0.0,873,0,63,936,936,0,0,936,315,0,0,0,219,0,0
158,2094,103.0,13125,0.0,48,634,422,1104,912,1215,0,2127,833,72,192,224,0,0,0
159,1460,0.0,9240,396.0,0,0,1055,1055,1055,1208,0,2263,905,0,45,0,0,189,0
160,1471,75.0,13125,215.0,994,0,484,1478,1493,0,0,1493,508,140,39,0,0,0,0
161,1509,70.0,11767,0.0,352,0,416,768,768,432,0,1200,240,0,0,0,0,0,0
162,1922,80.0,9250,0.0,480,468,108,1056,1056,0,0,1056,260,390,0,0,0,0,0
163,433,105.0,13693,472.0,2288,0,342,2630,2674,0,0,2674,762,360,50,0,0,0,0
164,460,48.0,6472,500.0,0,0,1451,1451,1456,0,0,1456,539,192,42,0,0,0,0
165,1116,78.0,10206,468.0,33,0,1530,1563,1563,0,0,1563,758,144,99,0,0,0,0
166,1137,66.0,13695,0.0,814,0,300,1114,1114,0,0,1114,576,0,78,0,0,0,0
167,53,43.0,3203,14.0,16,0,1129,1145,1145,0,0,1145,437,100,116,0,0,0,0
168,2354,75.0,9512,0.0,788,0,172,960,960,1358,0,2318,541,0,246,0,0,0,0
169,1475,75.0,9750,50.0,24,0,1421,1445,1445,0,0,1445,470,0,35,0,0,0,0
170,1761,160.0,15623,0.0,2096,0,300,2396,2411,2065,0,4476,813,171,78,0,0,0,555
171,842,60.0,8072,0.0,746,0,244,990,990,0,0,990,480,0,64,0,0,0,0
172,2739,78.0,11679,96.0,612,1164,0,1776,1560,0,0,1560,528,453,253,144,0,0,0
173,2509,24.0,2544,0.0,0,0,600,600,520,623,80,1223,480,0,166,0,0,0,0
174,1007,0.0,10832,0.0,0,0,712,712,1086,809,0,1895,409,143,46,0,0,0,0
175,2610,77.0,9786,0.0,600,0,312,912,1085,649,0,1734,440,0,0,0,0,128,0
176,1952,60.0,5400,0.0,0,0,691,691,691,0,0,691,216,0,20,94,0,0,0
177,2719,75.0,8235,99.0,483,0,1466,1949,1949,0,0,1949,586,32,0,0,0,0,0
178,2921,21.0,1894,0.0,252,0,294,546,546,546,0,1092,286,0,24,0,0,0,0
179,1966,70.0,7903,0.0,739,0,503,1242,1242,0,0,1242,324,0,0,0,0,0,0
180,292,51.0,9839,0.0,0,0,894,894,894,772,0,1666,0,0,156,0,0,0,0
181,1204,0.0,9900,342.0,552,0,280,832,1098,880,0,1978,486,0,43,0,0,0,0
182,1829,0.0,17542,0.0,125,1031,36,1192,1516,651,0,2167,518,220,47,0,0,0,0
183,2419,75.0,9073,0.0,0,0,738,738,738,754,0,1492,440,100,32,0,0,0,0
184,391,78.0,10140,174.0,0,0,1064,1064,1350,0,0,1350,478,0,0,0,0,0,0
185,798,60.0,9060,0.0,204,0,356,560,698,560,0,1258,280,0,0,0,0,0,0
186,481,0.0,8965,0.0,652,0,130,782,806,683,0,1489,400,0,75,0,0,0,0
187,193,0.0,7793,0.0,474,0,634,1108,1160,908,0,2068,315,0,0,60,0,0,0
188,555,63.0,9750,0.0,68,884,28,980,980,0,0,980,400,0,28,0,0,0,0
189,899,74.0,10206,0.0,0,0,0,0,944,0,0,944,528,0,0,0,0,0,0
190,2357,78.0,10140,0.0,194,0,638,832,832,832,0,1664,528,0,28,0,0,259,0
191,328,31.0,2394,0.0,915,0,30,945,945,0,0,945,253,174,0,56,0,108,0
192,1356,55.0,10267,0.0,210,606,0,816,838,0,0,838,275,0,0,112,0,0,0
193,1154,60.0,6360,0.0,489,0,375,864,864,0,0,864,276,0,0,0,0,0,0
194,1730,65.0,10237,0.0,0,0,783,783,783,701,0,1484,393,0,72,0,0,0,0
195,2249,0.0,7540,0.0,773,0,115,888,912,0,0,912,470,0,0,0,0,192,0
196,1119,80.0,9428,310.0,729,0,226,955,955,919,0,1874,880,168,108,0,0,0,0
197,2856,84.0,10164,0.0,646,0,346,992,992,473,0,1465,240,0,126,0,0,0,0
198,1394,85.0,13825,0.0,0,0,533,533,1021,580,0,1601,300,280,34,0,0,0,0
199,2587,55.0,7700,0.0,271,0,30,301,1145,0,0,1145,684,0,0,0,0,0,0
200,61,60.0,17433,114.0,0,0,1629,1629,1645,830,0,2475,962,23,172,0,0,256,0
201,2661,70.0,6300,0.0,0,0,1226,1226,1226,878,0,2104,432,0,341,88,0,0,0
202,2711,80.0,10366,0.0,456,0,456,912,934,0,0,934,336,77,0,0,0,0,0
203,1147,76.0,9291,120.0,426,0,406,832,832,878,0,1710,506,144,70,0,0,0,0
204,757,0.0,5775,0.0,0,0,483,483,741,686,0,1427,379,0,24,112,0,0,0
205,2623,60.0,7200,0.0,0,0,0,0,1040,0,0,1040,420,0,29,0,0,0,0
206,2378,24.0,2179,0.0,70,0,785,855,855,601,0,1456,460,0,28,0,0,0,0
207,1413,50.0,9360,216.0,324,0,297,621,621,648,0,1269,280,0,236,0,0,0,0
208,1722,44.0,6442,178.0,24,0,1346,1370,1370,0,0,1370,484,120,49,0,0,0,0
209,1112,86.0,14598,74.0,0,0,894,894,894,1039,0,1933,668,100,18,0,0,0,0
210,1623,0.0,8637,0.0,871,0,52,923,947,767,0,1714,451,256,48,0,0,0,0
211,1201,76.0,9120,270.0,442,0,459,901,943,933,0,1876,540,0,69,0,0,0,0
212,1513,67.0,5142,0.0,224,0,725,949,949,343,0,1292,205,0,0,183,0,0,0
213,957,150.0,215245,0.0,1236,820,80,2136,2036,0,0,2036,513,0,0,0,0,0,0
214,1171,35.0,4109,260.0,1141,0,416,1557,1557,0,0,1557,484,124,113,0,0,0,0
215,1145,75.0,8285,0.0,397,0,439,836,844,893,0,1737,506,192,85,0,0,0,0
216,2726,0.0,20355,123.0,810,826,229,1865,1830,0,0,1830,521,0,115,168,0,0,0
217,703,60.0,3378,0.0,0,0,651,651,707,682,0,1389,240,0,0,126,0,0,0
218,760,86.0,5160,0.0,749,63,46,858,892,0,0,892,0,0,0,105,0,160,0
219,1964,0.0,7500,0.0,574,0,466,1040,1040,0,0,1040,286,0,0,0,0,0,0
220,2512,35.0,3735,218.0,450,0,241,691,713,739,0,1452,506,0,34,0,0,0,0
221,159,64.0,6979,0.0,1056,0,0,1056,1056,0,0,1056,576,264,56,0,0,0,0
222,1281,71.0,7056,415.0,400,0,380,780,983,813,0,1796,483,0,50,0,0,0,0
223,468,122.0,11911,0.0,0,0,684,684,684,876,0,1560,400,100,38,0,0,0,0
224,290,0.0,7890,0.0,238,0,618,856,856,0,0,856,399,0,0,0,0,166,0
225,665,60.0,10800,0.0,0,0,720,720,846,0,0,846,576,0,0,0,0,0,0
226,1463,0.0,11250,0.0,0,0,1128,1128,1149,1141,0,2290,779,0,0,0,0,0,0
227,1792,70.0,9605,0.0,0,0,982,982,982,995,0,1977,574,240,53,0,0,0,0
228,923,80.0,14680,0.0,793,0,480,1273,1273,0,0,1273,307,483,0,0,0,115,0
229,500,79.0,10208,921.0,0,0,1264,1264,1277,1067,0,2344,889,220,0,0,0,0,0
230,1408,85.0,19550,0.0,1035,0,545,1580,1518,0,0,1518,0,0,39,0,0,0,0
231,331,21.0,1491,0.0,150,480,0,630,630,0,0,630,0,96,24,0,0,0,0
232,170,60.0,4800,771.0,48,0,661,709,1157,687,0,1844,240,84,0,0,0,0,0
233,2192,60.0,8172,0.0,544,0,224,768,768,0,0,768,355,0,0,196,0,0,0
234,2571,174.0,25419,0.0,1036,184,140,1360,1360,1360,392,3112,795,0,16,552,0,0,512
235,2314,0.0,13031,0.0,592,0,99,691,691,807,0,1498,409,315,44,0,0,0,0
236,2647,50.0,5633,0.0,0,0,844,844,844,0,0,844,216,50,81,123,0,0,0
237,422,110.0,14257,726.0,1360,0,416,1776,1794,978,0,2772,754,135,64,0,0,0,0
238,2457,49.0,20896,0.0,1721,0,356,2077,2097,0,0,2097,1134,192,267,0,0,0,0
239,1838,47.0,4230,0.0,0,0,1352,1352,1352,0,0,1352,466,0,241,0,0,0,0
240,2805,120.0,15611,0.0,0,0,1079,1079,1079,840,0,1919,685,0,51,0,0,0,0
241,1645,0.0,10960,0.0,256,0,1028,1284,1284,0,0,1284,480,0,0,192,0,0,0
242,1711,93.0,11999,340.0,0,0,1181,1181,1234,1140,0,2374,656,104,100,0,0,0,0
243,2825,90.0,11060,0.0,0,0,1150,1150,1164,1150,0,2314,502,0,274,0,0,0,0
244,322,89.0,13214,0.0,0,0,2002,2002,2018,0,0,2018,746,144,76,0,0,0,0
245,2103,66.0,10235,306.0,0,0,1643,1643,1651,0,0,1651,870,192,64,0,0,0,0
246,342,74.0,13008,0.0,564,0,318,882,882,0,0,882,502,0,0,0,0,0,0
247,600,60.0,7436,0.0,734,0,160,894,894,0,0,894,396,0,0,0,360,0,0
248,488,60.0,8123,16.0,0,0,982,982,1007,793,0,1800,463,100,63,0,0,0,0
249,1725,68.0,7820,362.0,0,0,1869,1869,1869,0,0,1869,617,210,54,0,0,0,0
250,2246,59.0,5568,473.0,1573,0,0,1573,1625,0,0,1625,495,123,0,0,0,153,0
251,2847,60.0,8400,0.0,388,0,552,940,1192,403,0,1595,240,0,0,108,0,0,0
252,806,80.0,9828,0.0,584,0,544,1128,1142,878,0,2020,466,0,155,0,0,0,0
253,530,75.0,9375,0.0,0,0,912,912,912,1182,0,2094,615,182,182,0,0,0,0
254,963,130.0,11457,0.0,1005,0,387,1392,1412,0,0,1412,576,0,0,169,0,0,0
255,2678,51.0,6120,0.0,347,0,381,728,728,434,0,1162,258,0,24,0,0,0,0
256,171,55.0,8800,0.0,0,0,576,576,792,348,0,1140,0,0,160,0,0,0,0
257,2401,56.0,20431,870.0,1410,0,438,1848,1848,880,0,2728,706,0,0,0,0,0,0
258,805,85.0,10560,0.0,474,0,605,1079,1079,800,0,1879,473,400,100,144,0,0,0
259,2259,149.0,19958,1224.0,0,0,585,585,2279,0,0,2279,461,274,0,0,0,138,0
260,1748,87.0,11084,0.0,192,0,192,384,744,630,0,1374,400,100,0,0,0,0,0
261,1361,60.0,10266,0.0,372,0,396,768,768,768,0,1536,308,0,216,80,0,0,0
262,1677,21.0,1890,285.0,356,0,316,672,672,546,0,1218,264,144,28,0,0,0,0
263,1406,85.0,10452,216.0,500,0,594,1094,1094,0,0,1094,495,0,0,0,0,287,0
264,2322,168.0,23257,0.0,0,0,868,868,887,1134,0,2021,422,0,100,0,0,0,0
265,688,76.0,7570,420.0,0,0,780,780,993,813,0,1806,483,0,55,0,0,0,0
266,143,70.0,8400,0.0,922,0,392,1314,1314,0,0,1314,294,250,0,0,0,0,0
267,804,75.0,9317,137.0,513,0,227,740,1006,769,0,1775,425,234,72,192,0,0,0
268,1214,82.0,9020,259.0,624,336,288,1248,1350,0,0,1350,520,176,0,0,0,0,0
269,2828,35.0,3675,82.0,547,0,0,547,1072,0,0,1072,525,0,44,0,0,0,0
270,1999,60.0,7200,0.0,1046,0,168,1214,1260,1031,0,2291,506,0,0,0,0,99,0
271,2467,65.0,8125,0.0,0,0,770,770,778,798,0,1576,614,0,50,0,0,0,0
272,2665,60.0,7200,0.0,0,0,596,596,998,764,0,1762,576,36,0,221,0,0,0
273,1538,0.0,14100,632.0,192,0,536,728,1968,1479,0,3447,1014,314,12,0,0,0,0
274,398,60.0,7038,0.0,726,0,138,864,864,0,0,864,576,210,0,0,0,0,0
275,2822,73.0,16133,0.0,847,0,329,1176,1176,0,0,1176,360,0,92,0,0,112,0
276,2157,36.0,4435,170.0,659,0,189,848,848,0,0,848,420,140,0,0,0,0,0
277,1856,0.0,16157,0.0,680,391,289,1360,1432,0,0,1432,588,168,180,0,0,0,0
278,1269,60.0,7200,0.0,0,0,0,0,1048,0,0,1048,420,0,27,0,0,0,0
279,2570,75.0,9000,0.0,812,0,124,936,1128,0,0,1128,286,0,0,0,0,0,0
280,2320,72.0,10463,0.0,0,0,893,893,901,900,0,1801,800,0,116,0,0,0,0
281,1517,0.0,12155,0.0,156,0,516,672,810,672,0,1482,400,0,0,254,0,0,0
282,2304,63.0,10712,0.0,212,0,762,974,974,0,0,974,0,0,28,0,0,0,0
283,1312,69.0,9143,0.0,0,0,346,346,709,308,0,1017,308,0,0,139,0,0,0
284,2012,60.0,6000,0.0,375,0,360,735,869,349,0,1218,440,0,0,0,0,0,0
285,506,0.0,29959,0.0,595,0,378,973,979,871,0,1850,467,168,98,0,0,0,0
286,2865,80.0,16560,0.0,503,0,449,952,1170,1175,0,2345,360,0,0,0,0,0,0
287,2367,21.0,1953,408.0,309,0,174,483,483,504,0,987,264,72,0,0,0,0,0
288,554,60.0,9000,0.0,0,0,784,784,784,0,0,784,360,0,0,91,0,0,0
289,238,68.0,9571,0.0,739,0,405,1144,1144,0,0,1144,596,44,0,0,0,0,0
290,1954,75.0,8700,53.0,192,0,728,920,888,0,0,888,240,0,0,0,0,0,0
291,2488,68.0,8927,0.0,0,0,0,0,1286,368,0,1654,528,0,0,0,0,0,0
292,2291,21.0,1890,0.0,0,0,546,546,546,546,0,1092,286,0,0,0,0,0,0
293,1969,70.0,7000,0.0,0,0,0,0,925,0,0,925,300,0,0,0,0,0,0
294,2725,0.0,14175,0.0,988,0,200,1188,1437,0,0,1437,576,304,0,0,0,0,0
295,1482,0.0,4426,147.0,697,0,151,848,848,0,0,848,420,149,0,0,0,0,0
296,2763,78.0,9316,532.0,0,0,784,784,784,812,0,1596,610,144,45,0,0,0,0
297,503,79.0,9085,286.0,816,0,254,1070,1094,967,0,2061,647,296,102,209,0,0,0
298,1584,82.0,11202,206.0,1029,0,403,1432,1440,0,0,1440,467,185,95,0,0,0,0
299,1531,0.0,9650,0.0,0,0,784,784,819,784,0,1603,599,0,217,0,0,0,0
300,2210,82.0,7136,423.0,484,0,495,979,979,979,0,1958,492,0,0,0,0,0,0
301,459,44.0,7390,308.0,800,0,1084,1884,1884,0,0,1884,649,231,90,0,0,0,0
302,556,71.0,7064,153.0,560,0,420,980,980,0,0,980,484,192,0,0,0,0,0
303,1347,51.0,6120,0.0,203,0,897,1100,1226,676,0,1902,576,0,139,55,0,0,0
304,1290,60.0,4800,0.0,0,0,672,672,672,0,0,672,256,0,0,0,0,0,0
305,1388,0.0,9000,0.0,288,0,718,1006,1006,0,0,1006,0,0,24,0,0,0,0
306,1571,0.0,164660,0.0,1249,147,103,1499,1619,167,0,1786,529,670,0,0,0,0,0
307,2754,64.0,6762,0.0,0,0,1286,1286,1294,0,0,1294,662,168,55,0,0,0,0
308,765,0.0,10547,0.0,1152,0,0,1152,1152,0,0,1152,252,0,0,0,0,0,0
309,2494,0.0,13052,0.0,712,0,312,1024,1024,0,0,1024,308,0,0,0,0,0,0
310,2870,78.0,15600,405.0,760,0,408,1168,1278,1037,0,2315,342,0,0,0,0,192,0
311,7,41.0,4920,0.0,616,0,722,1338,1338,0,0,1338,582,0,0,170,0,0,0
312,1114,74.0,13253,128.0,1096,0,482,1578,1578,0,0,1578,642,0,26,0,0,0,0
313,2418,96.0,11631,236.0,0,0,1052,1052,1052,1321,0,2373,632,120,46,0,0,0,0
314,291,60.0,7200,0.0,0,0,0,0,862,1788,0,2650,0,0,0,0,0,0,0
315,18,88.0,11394,350.0,1445,0,411,1856,1856,0,0,1856,834,113,0,0,0,0,0
316,39,83.0,10159,450.0,1646,0,284,1930,1940,0,0,1940,606,168,95,0,0,0,0
317,1001,45.0,6264,0.0,656,0,1008,1664,1682,0,0,1682,528,0,0,0,0,0,0
318,2442,66.0,8738,302.0,0,0,975,975,1005,1286,0,2291,429,192,0,0,0,0,0
319,616,0.0,7015,161.0,185,0,524,709,979,224,0,1203,352,0,0,248,0,0,0
320,2680,52.0,6240,0.0,0,0,0,0,672,240,0,912,0,0,0,0,0,0,0
321,1414,50.0,8405,0.0,241,391,229,861,961,406,0,1367,384,0,130,112,0,0,0
322,289,50.0,5000,0.0,218,0,808,1026,1026,665,0,1691,308,0,0,242,0,0,0
323,40,94.0,12883,256.0,0,0,1544,1544,1544,0,0,1544,868,0,35,0,0,0,0
324,860,60.0,7200,0.0,777,0,117,894,894,0,0,894,600,215,0,0,0,0,0
325,409,0.0,4928,0.0,958,0,0,958,958,0,0,958,440,0,60,0,0,0,0
326,673,64.0,8712,0.0,860,0,132,992,1306,0,0,1306,756,0,0,0,0,0,0
327,2427,43.0,3010,14.0,16,0,1126,1142,1142,0,0,1142,440,90,0,0,0,0,0
328,2036,60.0,9780,0.0,354,398,224,976,976,976,0,1952,299,285,0,0,0,216,0
329,2564,79.0,9462,0.0,0,0,704,704,1024,704,0,1728,234,245,60,0,0,0,0
330,642,76.0,9482,657.0,0,0,1866,1866,1866,0,0,1866,495,0,0,0,0,0,0
331,1008,0.0,14067,194.0,504,0,332,836,851,858,0,1709,416,0,40,0,0,0,0
332,1908,95.0,11345,567.0,220,0,708,928,928,992,0,1920,400,0,0,0,0,0,0
333,2519,0.0,3760,0.0,1009,182,44,1235,1235,0,0,1235,484,133,78,0,0,0,0
334,1369,60.0,10320,0.0,0,0,451,451,759,0,0,759,576,40,0,0,0,0,0
335,2855,54.0,7588,0.0,352,0,441,793,901,901,0,1802,216,0,0,40,0,0,0
336,712,60.0,8520,0.0,0,0,624,624,792,0,0,792,287,0,0,81,0,0,0
337,1943,60.0,14190,0.0,0,0,925,925,1000,544,0,1544,0,231,0,0,0,0,0
338,1958,60.0,11664,206.0,336,0,746,1082,1082,0,0,1082,240,0,130,0,0,0,0
339,107,30.0,4420,0.0,728,0,0,728,788,0,0,788,484,133,42,0,0,0,0
340,2295,61.0,33983,0.0,1112,0,48,1160,1676,0,0,1676,672,690,90,0,0,0,0
341,704,56.0,10134,0.0,0,0,801,801,801,646,0,1447,0,80,0,244,0,0,0
342,676,60.0,12144,0.0,375,0,457,832,1036,0,232,1268,288,0,28,0,0,0,0
343,259,70.0,8750,116.0,505,0,299,804,804,878,0,1682,523,0,77,0,0,0,0
344,93,88.0,11134,180.0,1129,0,261,1390,1402,823,0,2225,713,198,30,0,0,0,0
345,106,68.0,7379,0.0,484,0,491,975,975,873,0,1848,592,280,184,0,0,0,0
346,2315,54.0,9783,0.0,0,0,821,821,821,955,0,1776,443,286,116,0,0,0,0
347,1050,0.0,9477,65.0,340,0,524,864,892,0,0,892,264,0,0,0,0,0,0
348,1095,60.0,15384,0.0,724,0,64,788,788,702,0,1490,388,100,75,0,0,0,0
349,2709,0.0,11327,305.0,779,0,285,1064,1064,0,0,1064,528,314,48,0,0,0,0
350,758,41.0,5852,188.0,169,0,851,1020,978,886,0,1864,0,0,188,102,0,0,0
351,1496,72.0,7200,0.0,288,0,396,684,684,714,0,1398,440,0,0,0,0,0,0
352,2370,21.0,1680,281.0,317,0,355,672,672,546,0,1218,264,0,28,0,0,0,0
353,2458,85.0,10182,420.0,1220,0,440,1660,1660,0,0,1660,500,322,50,0,0,0,0
354,2733,75.0,9375,0.0,799,0,168,967,1350,0,0,1350,504,237,0,0,0,0,0
355,161,96.0,11275,300.0,0,0,710,710,1898,1080,0,2978,564,240,0,0,0,0,0
356,726,60.0,9720,0.0,0,0,741,741,780,741,0,1521,640,0,0,238,0,0,0
357,845,68.0,9017,0.0,560,0,871,1431,1431,0,0,1431,666,0,35,0,0,0,0
358,947,75.0,10125,0.0,445,250,412,1107,1040,1012,0,2052,642,210,91,0,0,0,0
359,2232,85.0,8500,0.0,0,0,793,793,997,520,0,1517,0,0,0,144,0,0,0
360,2563,79.0,9490,0.0,403,165,238,806,958,620,0,1578,240,0,0,32,0,0,0
361,2299,124.0,27697,198.0,811,0,585,1396,1608,0,0,1608,444,152,38,0,0,0,0
362,211,72.0,10632,0.0,0,0,689,689,725,499,0,1224,180,0,0,248,0,0,0
363,605,85.0,11475,95.0,0,0,1584,1584,1776,0,0,1776,888,0,25,0,0,0,0
364,1478,85.0,11049,0.0,0,0,1234,1234,1234,0,0,1234,484,0,30,0,0,0,0
365,2247,44.0,4750,481.0,1573,0,0,1573,1625,0,0,1625,538,123,0,0,0,153,0
366,2274,50.0,35133,226.0,1159,0,413,1572,1572,0,0,1572,995,0,263,0,0,263,0
367,2869,80.0,12984,459.0,1283,147,0,1430,1647,0,0,1647,621,0,0,0,0,0,0
368,967,75.0,9157,0.0,0,0,912,912,1072,942,0,2014,486,124,114,0,0,0,0
369,2656,49.0,5820,0.0,256,0,906,1162,1163,0,0,1163,220,142,98,0,0,0,0
370,667,81.0,9671,480.0,0,0,1248,1248,1248,1296,0,2544,907,0,0,0,0,0,0
371,1042,21.0,1890,422.0,483,0,0,483,483,504,0,987,352,411,0,0,0,0,0
372,2023,60.0,13515,0.0,0,0,764,764,1060,764,0,1824,520,0,0,126,0,0,0
373,2447,0.0,9233,877.0,1182,0,358,1540,1540,1315,0,2855,774,247,55,0,0,0,0
374,2055,70.0,8400,0.0,187,627,0,814,913,0,0,913,240,0,0,252,0,0,0
375,2275,93.0,15306,100.0,80,0,1652,1732,1776,0,0,1776,712,0,0,0,0,0,0
376,2204,55.0,7642,0.0,0,0,912,912,912,514,0,1426,216,0,240,0,0,0,0
377,1563,44.0,3842,174.0,1373,0,221,1594,1646,0,0,1646,482,128,53,0,0,155,0
378,483,34.0,5063,166.0,904,0,410,1314,1314,0,0,1314,626,172,62,0,0,0,0
379,796,42.0,4235,149.0,552,393,104,1049,1049,0,0,1049,266,0,105,0,0,0,0
380,1526,63.0,15576,0.0,0,0,840,840,840,840,0,1680,308,0,0,160,0,0,0
381,2042,60.0,10120,0.0,0,0,925,925,964,925,0,1889,308,0,0,264,0,0,0
382,442,102.0,13514,285.0,1142,0,632,1774,1808,0,0,1808,850,200,26,0,0,0,0
383,1693,110.0,13440,190.0,0,0,1108,1108,1148,1402,0,2550,670,120,39,0,0,0,0
384,1468,70.0,8750,0.0,642,0,273,915,933,975,0,1908,493,144,133,0,0,0,0
385,1430,0.0,11500,0.0,262,723,197,1182,1643,0,0,1643,438,339,0,0,0,0,0
386,2605,60.0,10800,0.0,664,0,290,954,1766,648,0,2414,520,142,0,0,0,0,0
387,1529,54.0,7609,0.0,406,0,392,798,798,714,0,1512,180,85,16,41,0,0,0
388,335,0.0,26142,189.0,593,0,595,1188,1188,0,0,1188,312,261,39,0,0,0,0
389,1287,57.0,9184,0.0,0,0,780,780,948,375,0,1323,400,0,0,0,0,0,0
390,31,21.0,1680,492.0,300,0,225,525,525,567,0,1092,320,0,0,0,0,0,0
391,1785,79.0,9416,205.0,1126,0,600,1726,1726,0,0,1726,786,171,138,0,0,266,0
392,82,70.0,8400,130.0,0,0,650,650,888,676,0,1564,476,0,50,0,0,204,0
393,2620,60.0,12144,0.0,455,0,455,910,910,611,0,1521,597,199,0,168,0,0,0
394,252,94.0,10402,0.0,0,0,1226,1226,1226,0,0,1226,740,0,36,0,0,0,0
395,721,0.0,3300,0.0,0,0,624,624,816,0,0,816,0,0,33,0,0,0,0
396,2165,64.0,8334,0.0,0,0,1330,1330,1330,0,0,1330,437,0,23,0,0,0,0
397,2316,70.0,11207,0.0,714,0,88,802,802,709,0,1511,413,95,75,0,0,0,0
398,775,0.0,7252,0.0,685,0,173,858,858,0,0,858,576,120,0,0,0,0,0
399,1558,120.0,18000,0.0,0,0,894,894,894,0,0,894,1248,0,20,0,0,0,0
400,17,152.0,12134,0.0,427,0,132,559,1080,672,0,1752,492,325,12,0,0,0,0
401,1022,85.0,14450,194.0,864,449,469,1782,1782,0,0,1782,551,467,0,0,0,0,0
402,925,54.0,7681,0.0,0,0,731,731,820,523,0,1343,186,192,0,102,0,0,0
403,438,87.0,11146,250.0,0,0,1709,1709,1717,0,0,1717,908,169,39,0,0,0,0
404,1270,70.0,7910,0.0,666,0,409,1075,1507,0,0,1507,404,0,0,0,0,0,0
405,1272,80.0,8000,0.0,520,319,188,1027,1027,0,0,1027,299,0,0,0,0,0,0
406,215,60.0,6048,0.0,736,0,120,856,936,744,0,1680,450,56,144,0,0,0,0
407,266,44.0,9548,223.0,483,0,458,941,941,888,0,1829,613,192,39,0,0,0,0
408,2402,74.0,10927,280.0,546,0,512,1058,1058,846,0,1904,736,179,60,0,0,0,0
409,1250,60.0,7350,0.0,852,0,100,952,952,0,0,952,840,0,0,0,0,0,0
410,1984,50.0,5925,435.0,168,0,739,907,1131,0,0,1131,672,0,72,0,0,0,0
411,1279,60.0,7200,0.0,370,0,398,768,1024,564,0,1588,480,0,0,0,0,0,0
412,377,0.0,12388,229.0,602,0,441,1043,1539,1134,0,2673,441,178,84,0,0,0,0
413,1252,71.0,8838,0.0,0,0,0,0,1764,0,0,1764,301,0,72,0,0,0,0
414,2156,80.0,10000,438.0,1079,0,141,1220,1220,870,0,2090,556,0,65,0,0,0,0
415,499,98.0,12203,975.0,854,0,371,1225,1276,1336,0,2612,676,250,0,0,0,0,0
416,1374,115.0,21286,0.0,0,0,720,720,720,551,0,1271,312,0,0,108,0,0,0
417,2898,0.0,11170,0.0,1216,0,0,1216,1298,1216,0,2514,693,0,0,0,0,0,0
418,401,70.0,10500,0.0,524,180,160,864,864,0,0,864,576,216,0,0,0,0,0
419,2721,88.0,13125,67.0,168,682,284,1134,1803,0,0,1803,484,0,0,0,0,0,0
420,2078,102.0,12671,300.0,353,0,935,1288,2422,0,0,2422,527,0,63,0,0,144,0
421,2589,80.0,13600,0.0,144,912,0,1056,1056,0,0,1056,300,0,0,0,0,0,0
422,1946,113.0,21281,0.0,0,0,666,666,1308,1778,0,3086,1200,0,208,290,0,156,0
423,1334,59.0,5870,0.0,0,0,554,554,736,554,0,1290,200,38,112,0,0,0,0
424,2781,118.0,13704,150.0,0,0,1541,1541,1541,0,0,1541,843,468,81,0,0,0,0
425,431,94.0,12220,305.0,1436,0,570,2006,2020,0,0,2020,900,156,54,0,0,0,0
426,576,61.0,3782,0.0,960,0,266,1226,1226,0,0,1226,484,133,78,0,0,0,0
427,1474,65.0,8450,196.0,706,0,150,856,856,854,0,1710,548,0,61,0,0,0,0
428,2254,0.0,8750,50.0,224,530,98,852,918,0,0,918,360,192,84,0,0,0,0
429,2155,90.0,11248,215.0,1059,0,567,1626,1668,0,0,1668,702,257,45,0,0,0,0
430,885,67.0,8777,0.0,0,0,0,0,1126,0,0,1126,520,0,96,0,0,0,0
431,643,53.0,8128,80.0,490,0,572,1062,1062,0,0,1062,297,0,0,0,0,0,0
432,1944,60.0,9600,0.0,220,0,625,845,893,0,0,893,576,0,0,0,0,0,0
433,480,61.0,10125,0.0,0,0,846,846,846,748,0,1594,434,300,48,0,0,0,0
434,2845,76.0,11388,0.0,0,0,616,616,1055,218,0,1273,275,212,0,0,0,0,0
435,2387,101.0,14215,380.0,0,0,1158,1158,1158,1218,0,2376,853,240,154,0,0,0,0
436,2407,40.0,6792,94.0,0,0,1368,1368,1368,0,0,1368,474,132,35,0,0,0,0
437,2527,90.0,11700,420.0,404,0,304,708,708,708,0,1416,776,0,169,0,0,119,0
438,2514,0.0,4447,0.0,0,0,530,530,530,550,0,1080,496,0,50,0,0,0,0
439,629,120.0,13560,216.0,0,0,1392,1392,1392,0,0,1392,576,0,0,240,0,0,0
440,80,0.0,9453,0.0,402,0,594,996,1014,730,0,1744,457,370,70,0,238,0,0
441,1876,0.0,10355,196.0,695,0,519,1214,1214,0,0,1214,318,0,111,0,0,0,0
442,1546,60.0,6000,0.0,0,0,720,720,760,330,0,1090,240,0,0,0,0,0,0
443,2518,0.0,11250,0.0,767,0,441,1208,1208,0,0,1208,546,198,42,0,0,0,0
444,2347,0.0,10464,130.0,850,0,138,988,1102,0,0,1102,582,140,22,0,0,0,0
445,783,65.0,25095,0.0,1324,0,113,1437,1473,0,0,1473,452,0,48,0,0,60,0
446,1322,60.0,11340,0.0,0,0,723,723,723,363,0,1086,400,0,24,144,0,0,0
447,194,50.0,5000,0.0,188,0,577,765,765,0,0,765,200,135,0,41,0,0,0
448,1770,95.0,11787,594.0,719,0,660,1379,1383,1015,0,2398,834,239,60,0,0,0,0
449,2143,60.0,7200,0.0,671,0,193,864,864,0,0,864,576,155,0,0,0,0,0
450,1229,0.0,13700,288.0,454,0,410,864,902,918,0,1820,492,60,84,0,0,273,0
451,511,85.0,10130,260.0,1294,0,408,1702,1702,0,0,1702,844,0,69,0,0,0,0
452,46,44.0,6371,128.0,733,0,625,1358,1358,0,0,1358,484,192,35,0,0,0,0
453,1348,51.0,6120,0.0,0,0,952,952,1022,752,0,1774,468,90,0,205,0,0,0
454,2465,65.0,8125,0.0,0,0,756,756,756,797,0,1553,615,0,45,0,0,0,0
455,387,0.0,8470,0.0,225,276,471,972,972,839,0,1811,565,225,48,0,0,0,0
456,873,70.0,8750,209.0,1111,0,306,1417,1417,0,0,1417,511,60,0,0,0,117,0
457,1918,65.0,6860,54.0,908,0,100,1008,1008,0,0,1008,308,0,0,0,0,0,0
458,2764,80.0,10041,0.0,789,0,119,908,927,988,0,1915,506,120,150,0,0,0,0
459,2184,64.0,6400,0.0,77,831,52,960,960,0,0,960,392,144,0,35,0,0,0
460,934,24.0,1488,0.0,471,0,90,561,561,668,0,1229,462,176,0,0,0,0,0
461,1920,70.0,8176,0.0,846,0,210,1056,1056,0,0,1056,308,0,0,0,0,0,0
462,2631,69.0,7590,266.0,512,0,148,660,660,688,0,1348,453,188,108,0,0,0,0
463,1768,104.0,21535,1170.0,1455,0,989,2444,2444,1872,0,4316,832,382,50,0,0,0,0
464,2040,40.0,4800,0.0,197,0,999,1196,1196,0,0,1196,440,0,0,0,0,0,0
465,1749,59.0,11796,0.0,0,0,847,847,847,1112,0,1959,434,100,48,0,0,0,0
466,834,0.0,16698,0.0,800,0,649,1449,944,815,0,1759,525,150,193,0,0,0,0
467,1457,0.0,10400,227.0,0,0,1257,1257,1290,871,0,2161,570,0,84,0,0,0,0
468,79,50.0,7175,0.0,623,121,0,744,752,0,0,752,264,353,0,0,0,90,0
469,2302,76.0,8314,0.0,546,0,270,816,816,0,0,816,264,168,0,0,0,0,0
470,1817,0.0,9180,0.0,747,93,0,840,884,0,0,884,504,240,0,0,0,0,0
471,2755,86.0,11210,240.0,20,0,1594,1614,1614,0,0,1614,865,144,59,0,0,0,0
472,359,0.0,8803,0.0,600,0,107,707,707,809,0,1516,409,0,46,0,0,0,0
473,2059,86.0,8665,89.0,168,288,420,876,897,0,0,897,264,0,0,0,0,0,0
474,2092,116.0,13474,246.0,700,0,0,700,1122,1121,0,2243,746,127,44,224,0,0,0
475,2516,60.0,7180,0.0,0,0,1568,1568,1568,0,0,1568,564,0,266,0,0,0,0
476,150,60.0,10950,0.0,339,0,525,864,1064,0,0,1064,318,0,0,0,0,0,0
477,1656,80.0,10793,263.0,493,287,0,780,780,840,0,1620,462,208,0,0,0,0,0
478,83,70.0,9800,0.0,0,0,816,816,1012,0,0,1012,429,121,0,80,0,0,0
479,2411,65.0,10237,0.0,28,0,1288,1316,1316,0,0,1316,397,100,0,0,23,0,0
480,795,0.0,11500,0.0,0,0,0,0,845,0,0,845,290,186,0,0,0,0,0
481,2312,0.0,13006,285.0,0,0,964,964,993,1243,0,2236,642,0,0,0,0,0,0
482,2917,21.0,1533,0.0,553,0,77,630,630,0,0,630,0,0,0,0,0,0,0
483,1624,63.0,7875,0.0,414,0,277,691,691,862,0,1553,420,0,44,0,0,0,0
484,2215,78.0,12168,0.0,428,0,537,965,1940,1254,0,3194,380,0,0,0,0,0,0
485,1211,80.0,9200,0.0,892,0,244,1136,1136,0,0,1136,384,426,0,0,0,0,0
486,1485,0.0,4438,169.0,662,0,186,848,848,0,0,848,420,140,0,0,0,0,0
487,1024,90.0,13068,621.0,890,48,273,1211,1211,0,0,1211,461,0,0,0,174,0,0
488,570,0.0,4217,252.0,962,0,183,1145,1256,0,0,1256,641,0,169,0,0,0,0
489,2874,50.0,7000,0.0,374,0,487,861,861,424,0,1285,506,96,0,132,0,0,0
490,700,60.0,6600,0.0,0,0,994,994,1378,994,0,2372,432,0,287,0,0,0,0
491,2756,73.0,8990,0.0,0,0,1498,1498,1498,0,0,1498,675,351,33,0,0,0,0
492,2022,47.0,7755,0.0,0,0,1100,1100,1100,1164,0,2264,408,0,152,0,0,0,0
493,583,0.0,10382,240.0,859,32,216,1107,1107,983,0,2090,484,235,204,228,0,0,0
494,2392,85.0,11924,286.0,998,0,177,1175,1182,1142,0,2324,736,147,21,0,0,0,0
495,2424,0.0,3072,18.0,0,0,1375,1375,1414,0,0,1414,398,144,20,0,0,0,0
496,212,60.0,9900,0.0,1026,0,186,1212,1212,180,0,1392,0,0,0,168,0,0,0
497,736,50.0,6000,0.0,0,0,884,884,884,464,0,1348,216,0,0,208,0,0,0
498,1610,0.0,11075,232.0,562,193,29,784,1168,800,0,1968,530,305,189,0,0,0,0
499,890,80.0,10682,0.0,399,0,615,1014,1149,0,0,1149,544,0,240,0,0,0,0
500,467,149.0,12589,0.0,0,0,742,742,742,742,0,1484,390,36,24,0,0,0,0
501,578,80.0,9600,200.0,0,0,392,392,1487,1012,0,2499,527,0,64,0,0,0,0
502,1747,65.0,16219,0.0,779,0,56,835,1119,0,0,1119,437,100,24,0,0,0,0
503,1149,55.0,7892,0.0,300,0,899,1199,1199,0,0,1199,530,0,63,0,0,0,0
504,2758,90.0,13377,0.0,1576,0,260,1836,1846,0,0,1846,495,0,32,0,0,0,0
505,857,0.0,7000,90.0,646,0,218,864,864,0,0,864,336,0,0,0,0,0,0
506,2219,70.0,10570,0.0,297,0,556,853,1549,1178,0,2727,440,0,74,0,0,0,0
507,733,0.0,8854,0.0,0,0,952,952,952,0,0,952,192,0,98,0,0,40,0
508,2909,41.0,2665,0.0,0,0,264,264,616,688,0,1304,336,141,0,0,0,0,0
509,1798,75.0,9000,0.0,0,0,1088,1088,1088,871,0,1959,1025,208,46,0,0,0,0
510,235,124.0,18600,0.0,288,684,0,972,1052,558,0,1610,480,0,0,60,0,0,0
511,2366,24.0,2160,200.0,402,0,363,765,765,600,0,1365,440,0,36,0,0,0,0
512,1027,75.0,9743,0.0,280,0,440,720,720,588,0,1308,484,0,0,0,0,0,0
513,1195,65.0,8125,0.0,260,456,196,912,925,0,0,925,576,233,0,0,0,0,0
514,1303,62.0,7311,0.0,0,0,407,407,407,0,0,407,297,76,0,120,0,0,0
515,148,80.0,10032,432.0,734,0,510,1244,1580,0,0,1580,440,0,28,0,0,160,0
516,608,115.0,10500,144.0,998,0,294,1292,1292,0,0,1292,520,0,32,0,0,92,0
517,2515,114.0,8314,0.0,0,0,569,569,854,840,0,1694,434,0,382,0,0,110,0
518,821,61.0,10226,270.0,0,0,1622,1622,1630,0,0,1630,860,172,42,0,0,0,0
519,2500,121.0,16059,284.0,0,0,1288,1288,1301,1116,0,2417,462,127,82,0,0,0,0
520,745,51.0,6120,0.0,0,0,960,960,995,0,0,995,264,0,15,51,0,0,0
521,741,51.0,6120,0.0,0,0,927,927,1067,472,0,1539,576,112,0,0,0,0,0
522,1611,0.0,56600,0.0,0,0,686,686,1150,686,0,1836,288,0,0,0,0,0,0
523,2532,75.0,9750,0.0,400,480,100,980,980,0,0,980,384,68,0,0,0,0,0
524,1081,0.0,3940,143.0,1073,0,342,1415,1455,0,0,1455,644,156,20,0,0,144,0
525,1692,107.0,13641,456.0,1304,0,630,1934,1943,713,0,2656,1040,268,58,0,0,0,0
526,2520,36.0,3640,0.0,860,0,176,1036,1036,0,0,1036,484,133,108,0,0,0,0
527,276,75.0,9825,0.0,0,0,0,0,1664,0,0,1664,0,0,0,0,0,0,0
528,1992,60.0,9600,0.0,0,0,702,702,842,630,0,1472,250,0,0,84,0,0,0
529,663,90.0,5400,0.0,0,0,416,416,599,0,0,599,0,0,81,0,0,0,0
530,418,24.0,2104,0.0,536,0,300,836,836,0,0,836,345,150,20,0,0,0,0
531,1733,63.0,9729,0.0,0,0,698,698,698,1048,0,1746,350,0,34,0,0,0,0
532,2359,80.0,10000,176.0,755,0,348,1103,1103,0,0,1103,462,295,84,0,0,0,0
533,253,64.0,7360,80.0,24,0,1198,1222,1222,0,0,1222,615,0,54,0,0,0,0
534,1518,60.0,8400,0.0,378,0,342,720,1052,720,420,2192,240,262,24,0,0,0,0
535,2035,50.0,9000,0.0,0,0,780,780,780,595,0,1375,544,0,162,0,0,126,0
536,2919,21.0,1526,0.0,0,0,546,546,546,546,0,1092,0,0,34,0,0,0,0
537,1540,70.0,12392,0.0,435,0,397,832,1218,943,0,2161,506,0,96,0,0,0,0
538,2120,0.0,14217,0.0,550,0,472,1022,1022,0,0,1022,747,0,0,0,0,0,0
539,1674,33.0,4113,0.0,0,0,1337,1337,1337,0,0,1337,511,136,68,0,0,0,0
540,256,80.0,8816,80.0,504,0,506,1010,1052,0,0,1052,440,0,0,0,0,0,0
541,2361,71.0,9353,0.0,0,0,864,864,864,0,0,864,280,0,0,0,0,0,0
542,978,21.0,1477,0.0,509,0,121,630,630,0,0,630,286,0,0,0,0,0,0
543,2280,62.0,6710,134.0,16,904,0,920,936,0,0,936,460,0,40,0,0,0,0
544,2095,82.0,11287,340.0,421,0,386,807,1175,807,0,1982,575,0,84,0,196,0,0
545,1709,99.0,12099,388.0,970,0,166,1136,1136,1332,0,2468,872,184,154,0,0,0,0
546,2801,75.0,9750,0.0,975,0,133,1108,1108,989,0,2097,583,253,170,0,0,0,0
547,1246,60.0,11556,52.0,148,0,572,720,882,0,0,882,240,0,0,0,0,0,0
548,2373,21.0,1680,297.0,0,0,483,483,483,504,0,987,288,0,0,0,0,0,0
549,1055,98.0,12704,302.0,1012,0,570,1582,1582,0,0,1582,905,209,95,0,0,0,0
550,2017,51.0,6120,0.0,351,0,405,756,903,378,0,1281,379,25,0,0,0,0,0
551,1099,84.0,9660,1290.0,0,0,1173,1173,1182,1017,0,2199,516,0,131,0,0,0,0
552,1344,0.0,6120,0.0,0,0,0,0,808,0,0,808,164,0,48,0,0,0,0
553,835,0.0,28698,0.0,249,764,0,1013,1160,966,0,2126,538,486,0,0,0,225,0
554,1117,91.0,12274,256.0,0,0,1417,1417,1428,0,0,1428,554,0,60,0,0,0,0
555,2043,55.0,4388,0.0,116,0,556,672,840,0,0,840,0,0,0,0,0,0,0
556,2085,39.0,3869,149.0,283,755,0,1038,1038,0,0,1038,264,0,105,0,0,0,0
557,410,24.0,2308,0.0,306,0,498,804,804,744,0,1548,440,108,0,0,0,0,0
558,2650,40.0,4400,0.0,0,0,648,648,734,384,0,1118,440,0,0,0,0,0,0
559,2867,70.0,14210,0.0,0,0,697,697,1104,697,0,1801,365,0,90,0,0,0,0
560,1668,61.0,9758,0.0,412,287,251,950,950,0,0,950,280,0,0,0,0,0,0
561,1161,35.0,4017,0.0,0,0,625,625,625,625,0,1250,625,0,54,0,0,0,0
562,2122,105.0,11249,0.0,334,544,322,1200,1200,0,0,1200,521,0,26,0,0,0,0
563,2539,80.0,9600,140.0,602,402,137,1141,1141,0,0,1141,568,0,78,0,0,0,0
564,1047,53.0,4043,0.0,559,0,510,1069,1069,0,0,1069,440,0,55,0,0,200,0
565,1445,0.0,9200,0.0,280,491,167,938,938,0,0,938,308,145,0,0,0,0,0
566,541,63.0,13072,0.0,0,0,1114,1114,1114,0,0,1114,0,0,39,0,0,0,0
567,569,0.0,3830,280.0,0,0,1726,1726,1726,0,0,1726,561,0,254,0,0,0,0
568,1276,59.0,7227,0.0,0,0,832,832,832,0,0,832,528,0,0,0,0,0,0
569,918,53.0,7155,0.0,0,0,600,600,628,600,0,1228,215,0,113,0,0,195,0
570,326,0.0,11875,0.0,0,0,1344,1344,1344,0,0,1344,686,328,0,0,0,0,0
571,1936,71.0,8540,0.0,114,691,120,925,925,0,0,925,252,152,0,0,0,0,0
572,895,64.0,6410,0.0,332,243,301,876,876,0,0,876,320,0,0,0,0,0,0
573,257,82.0,11105,0.0,870,0,0,870,965,0,0,965,580,71,0,0,0,0,0
574,1241,90.0,13200,187.0,958,0,437,1395,1570,0,0,1570,441,490,0,0,0,0,0
575,1545,50.0,7000,0.0,299,40,555,894,919,0,0,919,195,0,0,116,0,0,0
576,1189,80.0,11040,144.0,656,0,602,1258,1258,0,0,1258,528,55,0,0,216,0,0
577,270,0.0,4426,169.0,662,0,186,848,848,0,0,848,420,160,0,0,0,0,0
578,2066,99.0,16779,356.0,267,0,404,671,1567,1087,0,2654,638,128,570,0,0,0,0
579,693,60.0,10440,0.0,0,0,440,440,682,548,0,1230,440,74,0,128,0,0,0
580,1259,60.0,10836,0.0,0,0,892,892,1254,182,0,1436,1488,0,0,100,0,0,0
581,2916,80.0,13384,194.0,119,344,641,1104,1360,0,0,1360,336,160,0,0,0,0,0
582,2321,42.0,13751,248.0,60,0,1640,1700,1700,512,0,2212,773,237,38,0,0,115,0
583,1977,56.0,4480,0.0,782,0,240,1022,1022,0,0,1022,184,0,122,20,0,0,0
584,1895,0.0,11382,212.0,54,543,533,1130,1374,0,0,1374,286,0,28,84,0,0,0
585,1240,76.0,9120,0.0,662,0,599,1261,1261,0,0,1261,433,0,0,0,0,288,0
586,85,88.0,11782,0.0,899,0,210,1109,1155,0,0,1155,576,192,0,0,0,0,0
587,1823,85.0,6970,0.0,932,0,108,1040,1120,0,0,1120,544,168,0,0,0,0,0
588,825,77.0,11422,352.0,1359,0,479,1838,1838,0,0,1838,524,154,222,0,0,0,0
589,110,80.0,8000,0.0,833,0,659,1492,1492,0,0,1492,596,277,137,0,0,0,0
590,697,90.0,15660,0.0,0,0,240,240,810,496,0,1306,472,0,0,0,0,0,0
591,2297,50.0,6723,0.0,796,0,0,796,796,0,0,796,0,129,0,0,0,0,0
592,1231,75.0,7875,136.0,572,0,572,1144,1144,0,0,1144,456,0,0,0,0,0,0
593,1355,0.0,9144,0.0,399,0,484,883,988,517,0,1505,240,0,0,0,0,0,0
594,968,85.0,14601,584.0,1260,0,578,1838,1838,0,0,1838,765,270,68,0,0,0,0
595,584,0.0,12732,0.0,560,42,150,752,1285,782,0,2067,784,297,40,0,0,0,0
596,1315,60.0,6000,0.0,0,0,572,572,884,656,0,1540,0,240,77,0,0,0,0
597,1606,60.0,6600,0.0,816,0,0,816,816,0,0,816,816,0,0,0,0,0,0
598,206,110.0,8472,0.0,104,712,0,816,816,0,0,816,516,106,0,0,0,0,0
599,1685,96.0,12469,378.0,1151,0,639,1790,1816,0,0,1816,730,186,36,0,0,0,0
600,2016,52.0,6240,0.0,0,0,966,966,1014,412,0,1426,230,174,0,96,0,0,0
601,869,0.0,11250,0.0,0,0,944,944,944,926,0,1870,608,256,43,0,0,0,0
602,2135,97.0,11800,0.0,663,0,201,864,894,0,0,894,440,0,0,0,0,0,0
603,2346,0.0,18800,120.0,712,0,84,796,790,784,0,1574,566,306,111,0,0,0,0
604,2430,53.0,4045,45.0,1070,0,286,1356,1500,0,0,1500,648,161,20,0,0,0,0
605,2198,55.0,10594,0.0,0,0,768,768,789,0,0,789,200,0,0,112,0,0,0
606,2652,50.0,6000,0.0,576,0,384,960,960,0,0,960,576,0,0,0,0,0,0
607,27,70.0,8400,0.0,804,78,0,882,882,0,0,882,525,240,0,0,0,0,0
608,241,83.0,10420,0.0,36,0,1176,1212,1212,0,0,1212,460,100,22,0,0,0,0
609,906,70.0,6300,88.0,832,0,0,832,832,436,0,1268,250,0,0,55,0,0,0
610,1506,60.0,12180,0.0,0,0,585,585,585,468,0,1053,0,42,0,0,0,0,0
611,2098,77.0,9965,340.0,1150,0,316,1466,1466,1362,0,2828,1052,125,144,0,0,0,0
612,1435,0.0,8696,150.0,1308,0,110,1418,1418,0,0,1418,558,208,110,0,0,0,0
613,2213,126.0,13108,0.0,0,0,0,0,1226,0,0,1226,400,174,24,120,0,228,0
614,1274,60.0,8064,0.0,315,0,453,768,819,501,0,1320,576,108,0,0,0,0,0
615,743,51.0,6120,0.0,0,0,264,264,800,0,0,800,0,0,0,0,0,0,0
616,1737,73.0,8899,0.0,24,0,1316,1340,1340,0,0,1340,396,100,30,0,0,0,0
617,2797,67.0,10566,261.0,920,0,170,1090,1090,1124,0,2214,646,197,80,0,0,0,0
618,2185,74.0,6882,128.0,0,0,0,0,1152,0,0,1152,0,0,0,0,0,0,0
619,58,0.0,7750,0.0,250,0,134,384,774,656,0,1430,400,180,0,0,0,0,0
620,830,64.0,7314,82.0,724,0,508,1232,1232,0,0,1232,632,132,0,0,0,0,0
621,808,64.0,7018,0.0,0,0,0,0,1535,0,0,1535,410,0,0,0,0,0,0
622,680,60.0,7200,0.0,180,352,676,1208,1136,768,0,1904,240,0,0,168,0,0,0
623,1153,65.0,8450,0.0,890,0,0,890,890,0,0,890,308,0,0,0,0,0,0
624,1291,60.0,6000,0.0,0,0,728,728,728,728,0,1456,308,0,0,248,0,0,0
625,1818,60.0,8400,320.0,0,0,0,0,2020,0,0,2020,630,0,0,0,0,0,0
626,2161,70.0,8145,0.0,0,0,738,738,738,738,0,1476,552,0,35,0,0,0,0
627,1883,80.0,8892,66.0,0,0,1065,1065,1065,0,0,1065,461,74,0,0,0,0,0
628,350,28.0,7296,0.0,1965,0,243,2208,2522,0,0,2522,564,182,57,0,0,0,0
629,2473,63.0,13072,0.0,0,0,1131,1131,1131,0,0,1131,0,0,39,0,0,0,0
630,295,78.0,15600,430.0,375,0,657,1032,1102,1075,0,2177,484,0,0,0,0,0,0
631,293,50.0,9638,0.0,0,0,804,804,1699,748,0,2447,336,272,0,42,0,116,0
632,859,36.0,15523,0.0,460,0,404,864,864,0,0,864,338,0,0,0,0,0,0
633,288,45.0,8212,0.0,203,0,661,864,864,0,0,864,200,0,0,96,0,0,0
634,1578,73.0,9735,0.0,0,0,384,384,754,640,0,1394,400,100,0,0,0,0,0
635,102,0.0,2980,1159.0,466,0,290,756,756,756,0,1512,440,0,32,0,0,0,0
636,2831,24.0,2522,50.0,0,0,970,970,970,739,0,1709,380,0,40,0,0,0,0
637,1030,80.0,10400,120.0,0,0,1444,1444,1444,0,0,1444,473,0,24,0,0,0,0
638,2551,80.0,10800,88.0,632,0,616,1248,1248,0,0,1248,286,0,0,0,0,0,0
639,1286,60.0,10440,0.0,0,0,650,650,958,581,0,1539,686,70,78,68,0,0,0
640,958,89.0,12898,70.0,1022,0,598,1620,1620,0,0,1620,912,228,0,0,0,0,0
641,776,74.0,8740,0.0,672,0,168,840,860,0,0,860,528,0,0,0,0,0,0
642,72,84.0,10440,0.0,1414,0,54,1468,1468,0,0,1468,528,0,102,0,0,216,0
643,2263,89.0,10991,80.0,0,0,1571,1571,1571,0,0,1571,722,100,36,0,0,0,0
644,1866,0.0,8723,0.0,973,0,0,973,1082,0,0,1082,480,160,0,0,0,0,0
645,2876,50.0,7030,0.0,0,0,641,641,641,0,0,641,272,184,0,70,0,0,0
646,2146,0.0,9375,149.0,0,0,1284,1284,1284,885,0,2169,647,192,87,0,0,0,0
647,103,24.0,2572,0.0,604,0,92,696,696,720,0,1416,484,0,44,0,0,0,0
648,1500,35.0,3675,80.0,459,0,88,547,1072,0,0,1072,525,0,28,0,0,0,0
649,492,0.0,24682,0.0,0,0,841,841,892,783,0,1675,502,0,103,0,0,0,0
650,167,81.0,7635,0.0,588,350,237,1175,1175,0,0,1175,484,0,0,0,0,0,0
651,2597,90.0,5400,0.0,415,0,418,833,833,0,0,833,326,0,0,0,0,0,0
652,2685,58.0,6380,0.0,0,0,993,993,1048,0,0,1048,280,0,0,116,0,0,0
653,1035,65.0,9750,0.0,602,438,14,1054,1054,0,0,1054,460,180,0,0,0,80,0
654,1220,0.0,6627,0.0,0,0,0,0,720,0,0,720,287,0,0,0,0,0,0
655,2602,60.0,7200,0.0,338,0,325,663,774,821,0,1595,528,49,0,231,0,0,0
656,2159,65.0,8200,0.0,0,0,847,847,847,1081,0,1928,434,100,48,0,0,0,0
657,695,57.0,10307,0.0,633,0,339,972,972,972,0,1944,324,0,28,169,0,0,0
658,1109,81.0,10944,448.0,1000,0,223,1223,1223,904,0,2127,525,171,132,0,0,0,0
659,640,120.0,19296,399.0,672,690,0,1362,1382,0,0,1382,884,0,0,252,0,0,0
660,1652,0.0,10395,233.0,605,0,427,1032,1032,0,0,1032,564,0,0,0,0,0,0
661,2090,104.0,23920,0.0,0,0,1105,1105,1105,717,0,1822,515,0,195,1012,0,0,444
662,1188,85.0,11050,0.0,301,0,1439,1740,1740,0,0,1740,512,25,0,0,0,192,0
663,2345,0.0,16659,34.0,795,0,0,795,1468,795,0,2263,539,0,250,0,0,0,0
664,1059,108.0,13418,270.0,1420,0,430,1850,1850,898,0,2748,850,212,182,0,0,0,0
665,2751,133.0,11003,0.0,0,0,1308,1308,1308,568,0,1876,848,0,40,0,0,0,0
666,128,68.0,9724,265.0,670,0,470,1140,1929,532,0,2461,400,0,0,0,0,0,0
667,1523,64.0,7804,0.0,281,679,0,960,960,960,0,1920,480,248,0,121,0,0,0
668,2925,160.0,20000,0.0,1224,0,0,1224,1224,0,0,1224,576,474,0,0,0,0,0
669,2145,80.0,10386,246.0,1464,0,536,2000,2000,0,0,2000,888,168,0,0,0,0,0
670,1121,72.0,8640,0.0,24,0,1339,1363,1372,0,0,1372,588,192,113,0,0,0,0
671,566,32.0,2880,0.0,0,0,1376,1376,1376,1629,0,3005,704,0,177,0,0,0,0
672,565,0.0,11949,196.0,601,216,158,975,975,780,0,1755,524,502,60,0,0,0,0
673,1331,0.0,7010,0.0,175,0,849,1024,1144,594,0,1738,240,0,30,0,0,0,0
674,2928,62.0,10441,0.0,337,0,575,912,970,0,0,970,0,80,32,0,0,0,0
675,156,85.0,10200,104.0,320,362,404,1086,1086,0,0,1086,490,0,0,0,0,0,0
676,797,60.0,11409,0.0,292,0,476,768,1148,568,0,1716,281,0,0,0,0,160,0
677,327,0.0,1974,0.0,334,0,212,546,546,546,0,1092,286,120,96,0,0,0,0
678,2859,66.0,21780,0.0,0,0,817,817,940,610,0,1550,318,0,0,429,0,0,0
679,1453,60.0,7200,0.0,632,0,148,780,780,0,0,780,352,196,0,0,0,0,0
680,1762,100.0,12191,515.0,1181,0,598,1779,1779,772,0,2551,925,76,61,0,0,0,0
681,1868,108.0,11358,0.0,346,0,778,1124,1610,0,0,1610,515,202,0,0,0,256,0
682,1760,59.0,9649,0.0,0,0,941,941,961,683,0,1644,460,460,42,0,0,0,0
683,1113,75.0,11957,53.0,24,0,1550,1574,1574,0,0,1574,824,144,104,0,0,0,0
684,1812,0.0,11613,0.0,480,0,384,864,920,900,0,1820,492,144,85,0,0,0,0
685,117,80.0,9600,0.0,329,0,386,715,930,715,0,1645,441,0,78,0,0,0,0
686,1142,65.0,8125,258.0,1138,0,270,1408,1679,0,0,1679,575,224,42,0,0,0,0
687,2342,90.0,18261,420.0,1416,0,494,1910,2000,0,0,2000,722,351,102,0,0,123,0
688,927,70.0,9100,0.0,154,694,264,1112,1112,0,0,1112,390,0,0,0,0,0,0
689,2478,70.0,8304,0.0,0,0,941,941,941,896,0,1837,688,150,165,0,0,0,0
690,655,53.0,5470,0.0,0,0,792,792,792,0,0,792,366,0,90,0,0,0,0
691,2064,0.0,8169,0.0,216,435,261,912,912,0,0,912,315,204,0,0,0,0,0
692,369,124.0,16158,16.0,1274,0,256,1530,1530,0,0,1530,430,168,36,0,0,0,0
693,2239,59.0,8263,0.0,0,0,1012,1012,1012,0,0,1012,308,0,22,112,0,0,0
694,2732,0.0,5271,0.0,1082,0,371,1453,1453,0,0,1453,445,0,80,0,0,184,0
695,1653,79.0,11850,98.0,781,0,372,1153,1177,0,0,1177,495,204,103,0,0,0,0
696,959,83.0,13159,0.0,0,0,846,846,846,846,0,1692,650,208,114,0,0,0,0
697,2395,82.0,11643,142.0,880,0,644,1524,1544,814,0,2358,784,120,34,0,0,0,0
698,1412,50.0,9350,0.0,864,0,0,864,864,0,0,864,0,0,0,0,0,0,0
699,271,48.0,10635,171.0,370,972,315,1657,1668,0,0,1668,502,0,262,0,0,0,0
700,1484,0.0,4438,205.0,662,0,186,848,848,0,0,848,420,149,0,0,0,0,0
701,1497,60.0,7024,0.0,1024,0,108,1132,1132,0,0,1132,451,252,64,0,0,0,0
702,552,75.0,8250,0.0,0,0,0,0,964,918,0,1882,612,0,0,0,0,0,0
703,2,80.0,11622,0.0,468,144,270,882,896,0,0,896,730,140,0,0,0,120,0
704,1855,80.0,12000,600.0,1732,0,270,2002,2362,0,0,2362,546,180,16,0,0,0,0
705,4,93.0,11160,0.0,1065,0,1045,2110,2110,0,0,2110,522,0,0,0,0,0,0
706,2292,0.0,11333,0.0,539,0,490,1029,1062,0,0,1062,539,120,0,0,0,0,0
707,134,78.0,7800,200.0,540,0,728,1268,1268,0,0,1268,244,0,98,0,0,0,0
708,646,60.0,10434,0.0,0,0,1005,1005,1005,0,0,1005,672,0,0,0,0,0,0
709,42,90.0,11520,615.0,110,0,1588,1698,1698,0,0,1698,730,192,74,0,0,0,0
710,532,68.0,8736,0.0,771,360,422,1553,1553,0,0,1553,588,192,88,0,0,0,0
711,713,33.0,4456,0.0,0,0,736,736,736,716,0,1452,0,0,0,102,0,0,0
712,2561,80.0,9600,144.0,996,0,60,1056,1216,0,0,1216,280,0,0,0,0,0,0
713,2360,0.0,15870,0.0,75,791,230,1096,1096,0,0,1096,299,240,32,0,0,0,0
714,1333,50.0,5000,0.0,600,0,72,672,832,378,0,1210,240,0,0,0,0,0,0
715,1407,75.0,45600,0.0,0,0,907,907,1307,1051,0,2358,360,486,40,0,0,175,0
716,2892,42.0,26178,293.0,965,0,245,1210,1238,1281,0,2519,628,320,27,0,0,0,0
717,574,24.0,2645,456.0,649,0,321,970,983,756,0,1739,480,115,0,0,0,0,0
718,1227,80.0,9600,0.0,831,0,161,992,1661,0,0,1661,377,0,28,0,0,178,0
719,2591,118.0,21299,0.0,0,0,929,929,2039,0,0,2039,791,0,0,90,0,0,0
720,1476,65.0,8450,266.0,946,0,490,1436,1436,0,0,1436,484,139,98,0,0,0,0
721,1125,75.0,9375,768.0,0,0,1053,1053,1053,939,0,1992,648,140,45,0,0,0,0
722,1446,65.0,8385,220.0,595,0,390,985,985,0,0,985,328,210,0,0,0,0,0
723,408,21.0,1680,268.0,231,0,399,630,630,672,0,1302,264,185,0,0,0,0,0
724,1101,84.0,14260,350.0,655,0,490,1145,1145,1053,0,2198,836,192,84,0,0,0,0
725,2251,80.0,10000,166.0,585,0,856,1441,1392,0,0,1392,650,168,49,0,0,0,0
726,373,85.0,11900,209.0,822,0,564,1386,1411,0,0,1411,544,192,0,0,0,0,0
727,2554,68.0,9724,0.0,0,0,938,938,1043,0,0,1043,273,125,48,0,0,0,0
728,2382,110.0,16163,232.0,0,0,1618,1618,1618,0,0,1618,880,0,0,0,0,0,0
729,1985,50.0,5925,0.0,122,448,0,570,761,380,0,1141,252,0,0,96,0,0,0
730,519,72.0,8640,72.0,936,0,364,1300,1314,0,0,1314,552,135,112,0,0,0,0
731,1093,93.0,10261,318.0,0,0,936,936,962,830,0,1792,451,0,0,0,0,0,0
732,864,0.0,12334,198.0,0,0,1068,1068,1068,1116,0,2184,570,192,132,0,0,0,0
733,2889,78.0,10530,90.0,975,0,0,975,1004,0,0,1004,504,0,0,0,0,0,0
734,2308,0.0,11765,302.0,1127,0,490,1617,1797,0,0,1797,963,0,0,0,0,0,0
735,986,85.0,14115,0.0,732,0,64,796,796,566,0,1362,480,40,30,0,320,0,0
736,1302,75.0,9000,0.0,445,0,459,904,904,595,0,1499,869,0,20,0,0,0,0
737,585,0.0,12936,0.0,593,0,130,723,735,660,0,1395,497,294,116,0,0,0,0
738,2708,70.0,8414,0.0,663,0,396,1059,1068,0,0,1068,264,192,0,0,0,0,0
739,147,87.0,10725,91.0,936,0,270,1206,1206,0,0,1206,312,0,21,0,0,0,0
740,1441,88.0,12803,99.0,922,0,572,1494,1494,0,0,1494,530,192,36,0,0,0,0
741,383,0.0,10304,44.0,381,0,399,780,1088,780,0,1868,484,448,96,0,0,0,0
742,285,68.0,8562,145.0,383,0,833,1216,1526,0,0,1526,364,116,78,0,0,0,0
743,181,0.0,8239,0.0,176,0,832,1008,1060,185,0,1245,315,0,0,334,0,0,0
744,358,0.0,9765,68.0,310,0,370,680,680,790,0,1470,420,232,63,0,0,0,0
745,780,0.0,15584,366.0,0,0,825,825,2071,0,0,2071,336,131,28,0,0,0,0
746,258,0.0,9337,0.0,353,0,525,878,892,800,0,1692,513,0,39,0,0,0,0
747,1865,80.0,8000,525.0,915,0,93,1008,1403,1008,0,2411,570,0,192,0,0,0,0
748,692,0.0,3950,0.0,468,0,350,818,818,406,0,1224,210,0,0,116,0,0,0
749,2902,88.0,11443,208.0,1460,0,408,1868,2028,0,0,2028,880,326,66,0,0,0,0
750,508,86.0,11194,240.0,0,0,1696,1696,1696,0,0,1696,972,120,56,0,0,0,0
751,2638,60.0,9600,264.0,276,0,936,1212,1226,442,0,1668,240,0,0,140,0,0,0
752,36,24.0,2280,0.0,311,0,544,855,855,601,0,1456,440,26,0,0,0,0,0
753,611,0.0,12095,115.0,564,0,563,1127,1445,0,0,1445,645,180,0,0,0,0,0
754,2281,94.0,25286,0.0,633,0,431,1064,1040,0,0,1040,648,0,0,0,0,0,0
755,1678,21.0,2058,265.0,0,0,672,672,672,546,0,1218,264,0,28,0,0,0,0
756,1696,107.0,13891,456.0,1812,0,740,2552,2552,0,0,2552,932,130,28,0,0,0,0
757,1557,52.0,5150,0.0,0,0,356,356,671,378,0,1049,195,0,0,0,0,0,0
758,2180,60.0,7023,0.0,611,0,123,734,734,674,0,1408,489,0,85,0,0,0,0
759,1726,48.0,6240,176.0,24,0,1300,1324,1324,0,0,1324,550,0,38,0,0,0,0
760,951,75.0,9750,0.0,767,0,135,902,926,0,0,926,351,319,0,0,0,0,0
761,267,75.0,9375,0.0,0,0,1040,1040,1044,1054,0,2098,621,331,38,0,0,0,0
762,2706,75.0,11235,51.0,547,0,504,1051,1382,0,0,1382,459,0,82,0,0,0,0
763,2221,110.0,14442,106.0,1186,0,291,1477,1839,0,0,1839,416,0,87,0,0,200,0
764,1357,57.0,8094,0.0,196,0,1046,1242,1242,742,0,1984,360,64,0,180,0,0,0
765,2901,95.0,13618,198.0,1350,0,378,1728,1960,0,0,1960,714,172,38,0,0,0,0
766,347,60.0,8400,32.0,284,0,100,384,958,670,0,1628,390,48,72,0,0,0,0
767,2164,65.0,8769,0.0,709,0,460,1169,1190,0,0,1190,578,100,41,0,0,0,0
768,1586,85.0,12244,226.0,871,0,611,1482,1482,780,0,2262,749,168,0,0,0,0,0
769,360,58.0,7250,45.0,0,0,1181,1181,1190,0,0,1190,430,0,21,0,0,0,0
770,1769,92.0,9920,0.0,862,0,255,1117,1127,886,0,2013,455,180,130,0,0,0,0
771,2617,86.0,11650,58.0,0,0,0,0,1472,0,0,1472,484,0,68,0,0,227,0
772,1879,0.0,10624,84.0,40,264,1424,1728,1728,0,0,1728,352,155,0,0,0,0,0
773,991,0.0,12925,0.0,865,0,340,1205,2117,0,0,2117,550,0,42,0,0,0,0
774,1535,0.0,9260,0.0,0,0,884,884,932,442,0,1374,225,64,0,0,0,100,0
775,1191,75.0,9750,0.0,0,0,1625,1625,1625,0,0,1625,484,0,0,0,0,0,0
776,1579,81.0,12018,60.0,0,0,796,796,796,816,0,1612,666,0,64,0,0,0,0
777,1882,0.0,12772,0.0,498,0,460,958,958,0,0,958,301,0,0,0,0,0,0
778,1510,60.0,8172,0.0,0,0,941,941,997,473,0,1470,548,0,0,0,0,156,0
779,2196,60.0,10890,0.0,371,0,925,1296,1296,1296,0,2592,0,0,742,240,0,0,0
780,1845,0.0,2117,513.0,420,0,336,756,756,756,0,1512,440,0,32,0,0,0,0
781,2336,92.0,15922,550.0,0,0,1390,1390,1390,1405,0,2795,660,272,102,0,0,0,0
782,942,60.0,6402,0.0,0,0,596,596,596,596,0,1192,189,0,0,137,0,0,0
783,861,60.0,7200,0.0,660,0,108,768,768,0,0,768,396,192,0,0,0,0,0
784,2555,51.0,4712,0.0,384,0,363,747,774,456,0,1230,305,0,57,0,0,63,0
785,1392,0.0,13284,0.0,1064,0,319,1383,1383,0,0,1383,354,511,116,0,0,0,0
786,2099,71.0,9178,306.0,0,0,1643,1643,1651,0,0,1651,870,204,64,0,0,0,0
787,1543,24.0,1879,0.0,366,0,150,516,516,516,0,1032,462,213,0,0,0,0,0
788,948,48.0,12822,0.0,1351,0,83,1434,1518,631,0,2149,670,168,43,0,0,198,0
789,1239,82.0,9840,0.0,1053,0,195,1248,1440,0,0,1440,480,150,0,0,0,256,0
790,22,85.0,10625,81.0,885,168,0,1053,1173,0,0,1173,528,0,120,0,0,0,0
791,2796,0.0,8125,295.0,986,0,668,1654,1654,0,0,1654,900,0,136,0,0,0,0
792,2747,0.0,11200,85.0,1258,0,40,1298,1298,0,0,1298,403,165,26,0,0,0,0
793,92,85.0,13143,504.0,250,981,0,1231,1251,1098,0,2349,762,32,130,0,0,0,0
794,210,100.0,15263,90.0,766,0,656,1422,1675,0,0,1675,365,0,132,0,0,0,0
795,1858,40.0,3840,0.0,881,176,0,1057,1295,0,0,1295,571,133,89,0,0,0,0
796,2228,35.0,3907,0.0,577,0,427,1004,1020,0,0,1020,509,135,0,0,0,0,0
797,447,79.0,9541,268.0,0,0,1502,1502,1502,0,0,1502,644,0,114,0,0,0,0
798,827,68.0,8814,180.0,1334,0,270,1604,1604,0,0,1604,660,123,110,0,0,0,0
799,1649,61.0,11339,549.0,758,0,22,780,1085,845,0,1930,481,192,72,0,0,0,0
800,682,70.0,7560,0.0,504,0,525,1029,1339,0,0,1339,294,0,0,0,0,0,0
801,2698,60.0,7200,0.0,343,0,641,984,984,0,0,984,308,0,0,164,0,0,0
802,494,64.0,7848,0.0,0,0,384,384,774,656,0,1430,410,0,0,0,0,0,0
803,214,0.0,6449,0.0,73,0,634,707,942,942,0,1884,0,0,0,239,0,0,0
804,2441,0.0,12104,0.0,0,0,1035,1035,1082,1240,0,2322,617,400,45,0,0,0,0
805,2679,51.0,6120,0.0,489,0,279,768,1015,0,0,1015,450,0,0,112,0,120,0
806,1336,50.0,6000,0.0,0,0,949,949,949,0,0,949,370,0,0,48,0,0,0
807,465,63.0,10928,0.0,0,0,728,728,728,728,0,1456,390,100,0,0,0,0,0
808,1524,66.0,8969,0.0,379,0,265,644,672,644,0,1316,369,0,0,0,0,192,0
809,2543,70.0,9100,0.0,521,174,169,864,864,0,0,864,624,0,0,0,0,0,0
810,631,73.0,8760,164.0,856,0,313,1169,1144,0,0,1144,286,257,0,0,0,0,0
811,2452,0.0,10236,501.0,380,168,742,1290,1305,1189,0,2494,803,200,95,0,0,0,0
812,228,0.0,11616,328.0,438,0,234,672,672,714,0,1386,440,335,0,0,0,0,0
813,126,98.0,13260,144.0,1500,0,228,1728,1728,0,0,1728,0,0,0,0,0,0,0
814,1092,55.0,7301,176.0,876,0,474,1350,1358,0,0,1358,484,192,26,0,0,0,0
815,1122,72.0,8640,0.0,0,0,1372,1372,1372,0,0,1372,529,0,140,0,0,0,0
816,932,100.0,17500,420.0,784,435,91,1310,1906,0,0,1906,576,0,201,0,0,0,0
817,1980,60.0,10800,0.0,0,0,641,641,1047,0,0,1047,273,0,0,0,0,0,0
818,2171,73.0,10921,48.0,520,0,440,960,960,0,0,960,432,120,0,0,0,0,0
819,551,0.0,10274,141.0,331,0,345,676,698,702,0,1400,465,0,48,0,0,0,0
820,2768,80.0,12000,0.0,853,0,535,1388,1388,0,0,1388,522,0,58,0,0,0,0
821,2056,99.0,7094,0.0,180,374,340,894,894,0,0,894,384,0,0,0,0,0,0
822,1159,105.0,11025,568.0,520,0,1328,1848,1827,959,0,2786,636,294,49,0,0,0,0
823,2645,56.0,7745,0.0,0,0,938,938,1084,867,0,1951,576,0,6,28,0,0,0
824,1174,24.0,2160,216.0,600,0,72,672,684,720,0,1404,462,20,0,0,0,0,0
825,2266,44.0,13758,117.0,902,0,254,1156,1187,530,0,1717,400,168,36,0,0,0,0
826,2462,100.0,13162,0.0,1836,0,200,2036,2036,604,0,2640,792,0,265,0,0,0,0
827,1219,0.0,11332,0.0,528,0,590,1118,1118,0,0,1118,264,290,0,0,0,0,0
828,2922,55.0,12640,0.0,936,396,396,1728,1728,0,0,1728,574,40,0,0,0,0,0
829,118,80.0,9600,172.0,698,0,534,1232,1232,0,0,1232,490,0,224,0,0,0,0
830,474,43.0,3182,11.0,16,0,1129,1145,1145,0,0,1145,397,100,16,0,0,0,0
831,2576,80.0,11600,175.0,565,0,818,1383,1383,0,0,1383,292,0,45,0,0,0,0
832,872,0.0,12782,164.0,1360,0,462,1822,1828,0,0,1828,523,194,144,0,0,0,0
833,1077,48.0,6240,196.0,24,0,1318,1342,1342,0,0,1342,550,0,35,0,0,0,0
834,1536,79.0,7801,88.0,500,0,591,1091,1091,0,0,1091,344,66,105,0,0,221,0
835,1150,70.0,9100,0.0,53,799,132,984,984,0,0,984,384,145,56,0,0,0,0
836,2341,69.0,11302,238.0,1422,0,392,1814,1826,0,0,1826,758,180,75,0,0,120,0
837,1931,60.0,11556,0.0,408,0,456,864,1154,0,0,1154,336,63,0,0,0,0,0
838,2785,69.0,9920,0.0,523,0,448,971,971,0,0,971,300,0,0,0,0,0,0
839,2538,0.0,9759,0.0,799,0,252,1051,1051,0,0,1051,264,182,88,0,0,0,0
840,597,80.0,9600,252.0,698,0,467,1165,1165,896,0,2061,498,0,77,0,0,196,0
841,464,36.0,2268,106.0,567,0,197,764,764,862,0,1626,474,0,27,0,0,0,0
842,233,0.0,23595,0.0,1258,0,74,1332,1332,192,0,1524,586,268,0,0,0,0,0
843,2169,75.0,9825,162.0,936,0,0,936,936,0,0,936,384,405,0,0,0,0,0
844,2123,57.0,10021,0.0,539,0,96,635,646,662,0,1308,497,142,54,0,0,0,0
845,1867,130.0,11700,196.0,910,0,385,1295,1295,0,0,1295,528,0,194,0,0,200,0
846,137,0.0,19900,287.0,912,0,1035,1947,2207,0,0,2207,576,301,0,0,0,0,0
847,515,72.0,8640,0.0,822,0,78,900,932,920,0,1852,644,168,108,0,0,0,0
848,933,24.0,1733,0.0,0,0,516,516,516,516,0,1032,452,279,0,0,0,0,0
849,2784,42.0,10385,123.0,595,400,0,995,1282,0,0,1282,672,386,0,0,0,0,0
850,972,32.0,4500,320.0,866,0,338,1204,1204,0,0,1204,412,0,247,0,0,0,0
851,599,0.0,9790,0.0,251,630,491,1372,1342,0,0,1342,457,0,0,0,0,197,0
852,2614,60.0,7332,207.0,414,0,450,864,864,0,0,864,288,168,0,0,0,0,0
853,2582,0.0,7032,0.0,943,0,0,943,943,0,0,943,600,42,0,0,0,0,0
854,1409,66.0,21780,0.0,0,0,1163,1163,1163,511,0,1674,396,72,36,0,0,144,0
855,175,60.0,5790,0.0,0,0,840,840,840,765,0,1605,379,0,0,202,0,0,0
856,352,61.0,7380,0.0,341,0,1077,1418,1478,0,0,1478,495,168,43,0,0,0,0
857,976,21.0,1526,0.0,515,0,115,630,630,0,0,630,286,0,0,0,0,0,0
858,2134,72.0,11317,101.0,0,0,840,840,840,828,0,1668,500,144,68,0,0,0,0
859,984,0.0,8780,0.0,625,0,208,833,833,0,0,833,0,0,0,0,0,0,0
860,2396,90.0,12378,0.0,1274,0,622,1896,1944,0,0,1944,708,208,175,0,0,0,0
861,1673,34.0,4058,182.0,584,139,0,723,767,0,0,767,367,120,40,0,0,0,0
862,404,24.0,2368,312.0,765,0,0,765,765,600,0,1365,440,0,36,0,0,0,0
863,607,85.0,9350,217.0,310,512,491,1313,1313,0,0,1313,610,172,28,0,0,121,0
864,814,64.0,7040,216.0,1094,0,0,1094,1229,0,0,1229,672,120,0,0,0,0,0
865,868,70.0,8749,0.0,0,0,840,840,840,885,0,1725,550,0,48,0,0,0,0
866,2271,0.0,7777,203.0,0,0,1491,1491,1491,0,0,1491,571,0,35,0,0,0,0
867,1633,0.0,5062,0.0,828,182,180,1190,1190,900,0,2090,577,219,0,0,0,0,0
868,337,70.0,7700,0.0,0,0,1216,1216,1216,1216,0,2432,616,200,0,0,0,0,0
869,2765,0.0,36500,621.0,812,0,812,1624,1582,0,0,1582,390,168,198,0,0,0,0
870,1746,182.0,14572,0.0,1300,0,230,1530,1530,0,0,1530,630,144,36,0,0,0,0
871,368,80.0,11844,464.0,0,0,2046,2046,2046,0,0,2046,834,322,82,0,0,0,0
872,2806,70.0,8810,0.0,1000,0,390,1390,1390,0,0,1390,545,0,68,0,0,0,0
873,1662,80.0,8000,0.0,931,153,0,1084,1084,793,0,1877,488,0,96,0,0,0,0
874,1234,90.0,14670,410.0,575,0,529,1104,1104,884,0,1988,480,0,230,0,0,0,0
875,1373,55.0,8250,0.0,250,492,210,952,1211,0,0,1211,322,0,63,0,0,0,0
876,1672,60.0,9000,0.0,616,0,248,864,864,0,0,864,528,0,0,0,0,0,0
877,1939,70.0,8400,0.0,793,0,130,923,925,0,0,925,390,81,0,0,0,0,0
